155,155,155,155,155,155,155,155,155,155,155,155,155,155,155,155,155,155,155,155,155,155,155,155,155,155,155,155,155,155
155,201,0,0,0,0,0,0,0,0,0,0,0,0,0,0,0,0,0,0,0,0,0,0,0,0,0,0,0,155,
155,193,0,221,0,0,0,0,0,0,0,0,0,0,0,0,0,0,0,0,0,0,0,0,0,162,0,0,0,155,
155,209,0,0,0,0,0,0,0,0,0,0,0,0,147,135,135,123,44,44,147,135,135,135,135,135,88,88,88,155,
155,135,135,123,0,0,0,100,88,76,0,0,0,0,0,0,0,0,0,0,0,0,198,0,0,155,0,198,0,155,
155,0,55,0,0,0,0,0,0,0,0,0,0,0,0,0,0,0,0,0,0,0,0,0,0,155,0,0,0,155,
155,65,55,0,0,0,0,0,0,0,0,0,0,100,135,0,0,0,0,0,0,100,88,135,55,155,88,88,88,155,
155,135,135,123,0,0,0,100,88,76,0,0,0,0,155,0,0,0,0,0,0,0,0,155,209,209,209,209,209,155,
155,198,0,0,0,0,0,0,0,0,0,0,0,0,155,0,0,0,0,0,0,0,0,155,209,209,209,209,209,155,
155,0,0,0,0,0,0,0,0,0,0,0,0,0,155,0,100,88,88,88,88,135,55,155,135,135,88,88,88,155,
155,0,0,0,0,0,0,0,0,112,0,0,0,0,155,0,0,0,0,0,0,155,0,0,193,193,193,193,193,155,
155,0,0,61,0,0,0,0,0,0,0,0,0,0,155,0,0,0,0,0,0,155,0,162,193,193,193,193,193,155,
155,0,0,29,0,0,0,0,0,0,0,0,0,0,155,139,139,139,139,135,55,155,135,135,88,88,88,88,88,155,
155,0,0,0,0,0,0,0,0,0,0,0,135,135,155,8,8,8,8,155,0,0,0,0,201,201,201,201,201,155,
155,0,0,0,0,0,0,0,0,0,0,135,155,155,155,8,8,8,8,155,0,0,0,0,201,201,201,201,201,155,
155,135,135,135,135,135,135,135,135,135,135,155,155,155,155,155,155,155,155,155,135,135,135,135,135,135,135,135,135,155,
155,155,155,155,155,155,155,155,155,155,155,155,155,155,155,155,155,155,155,155,155,155,155,155,155,155,155,155,155,155