155,155,155,155,155,155,155,155,155,155,155,155,155,155,155,155,155,155,155,155,155,155,155,155,155,155,155,155,155,155,
155,0,0,0,0,0,0,0,0,0,0,0,0,0,0,0,0,0,0,0,0,0,155,0,0,0,0,209,0,155,
155,0,0,0,0,0,0,0,0,0,0,0,0,0,0,0,0,0,0,0,0,198,155,0,0,0,0,0,0,155,
155,0,0,0,0,0,44,44,0,0,147,135,135,135,135,135,123,55,147,135,135,135,155,135,55,135,0,0,0,155,
155,0,0,0,0,0,0,0,0,0,0,0,0,0,0,0,0,0,0,0,0,0,0,0,0,155,201,0,0,155,
155,0,0,0,0,0,0,0,0,0,0,0,0,0,0,0,0,0,0,0,0,0,0,0,162,155,61,0,0,155,
155,0,0,100,88,76,0,0,100,76,0,0,44,0,0,0,147,135,135,123,0,0,147,135,135,155,0,0,0,155,
155,0,0,0,0,0,0,0,201,201,0,0,0,0,0,0,0,0,0,0,0,0,0,0,201,155,0,0,193,155,
155,0,0,0,0,0,193,0,0,0,0,193,0,0,0,0,0,0,0,0,0,0,0,0,0,155,0,0,0,155,
155,0,100,76,0,0,0,0,0,0,0,0,0,0,0,0,0,100,76,0,0,0,0,0,100,155,0,0,0,155,
155,221,0,0,0,0,0,209,209,209,209,0,0,0,0,0,209,0,0,0,0,0,0,0,0,155,0,0,61,155,
155,0,0,0,0,0,0,0,0,0,0,0,0,0,0,0,0,0,0,0,0,0,0,0,198,155,0,0,0,155,
155,135,135,135,0,0,0,0,0,0,0,0,0,0,0,135,139,139,139,139,139,139,139,135,135,155,0,65,0,155,
155,155,155,155,135,135,135,135,135,135,135,135,135,135,135,155,8,8,8,8,8,8,8,155,155,155,135,135,135,155,
155,155,155,155,155,155,155,155,155,155,155,155,155,155,155,155,155,155,155,155,155,155,155,155,155,155,155,155,155,155