155,155,155,155,155,155,155,155,155,155,155,155,155,155,155,155,155,155,155,155,155,155,155,155,155
155,0,0,0,0,0,61,61,0,0,0,0,0,0,0,0,0,0,0,0,0,209,193,201,155,
155,0,221,0,0,0,0,0,0,0,0,0,0,0,0,0,0,0,0,0,0,0,209,193,155,
155,0,0,0,0,0,0,0,0,0,0,0,0,0,0,0,0,0,0,0,0,0,0,209,155,
155,0,0,0,0,0,0,0,0,0,0,0,0,0,0,0,0,0,0,0,0,0,0,0,155,
155,0,0,0,0,0,61,61,135,135,135,123,0,147,135,135,135,0,0,0,0,0,44,44,155,
155,135,135,135,135,135,135,135,155,0,0,0,0,0,0,0,155,135,135,135,135,135,135,135,155,
155,0,0,0,0,0,0,0,0,0,0,0,0,0,0,0,0,0,0,0,0,0,0,0,155,
155,0,0,0,0,0,0,0,0,0,0,0,0,0,0,0,0,0,0,0,0,0,0,0,155,
155,198,0,0,0,0,0,0,0,0,0,0,0,0,0,0,0,0,0,0,0,0,0,0,155,
155,135,135,135,135,135,135,135,135,135,123,44,44,44,147,135,135,135,135,135,135,135,123,55,155,
155,0,0,0,0,0,0,0,0,0,0,0,0,0,0,0,0,0,0,0,0,0,0,0,155,
155,65,0,0,0,0,0,0,0,0,0,0,0,0,0,0,0,0,0,0,0,0,0,0,155,
155,135,135,135,139,139,139,135,135,135,135,139,139,139,135,135,135,135,139,139,139,135,135,135,155,
155,155,155,155,155,155,155,155,155,155,155,155,155,155,155,155,155,155,155,155,155,155,155,155,155