155,155,155,155,155,155,155,155,155,155,155,155,155,155,155,155,155,155,155,155,155,155,155,155,155
155,0,0,0,0,0,0,0,0,0,0,0,0,0,0,0,0,0,0,0,0,209,193,201,155,
155,0,0,0,0,0,0,0,0,0,0,0,0,0,0,0,0,0,0,0,0,0,209,193,155,
155,0,0,0,0,112,0,0,0,112,0,0,0,112,0,0,0,112,0,0,0,0,0,209,155,
155,198,0,0,0,0,0,0,0,0,0,0,0,0,0,0,0,0,0,0,0,0,0,0,155,
155,0,0,0,0,44,0,201,0,44,0,193,0,44,0,209,0,44,0,162,0,0,0,0,155,
155,0,100,76,0,0,0,112,0,0,0,112,0,0,0,112,0,0,0,135,0,0,0,0,155,
155,139,139,139,139,139,139,139,139,139,139,139,139,139,139,139,139,139,139,155,0,0,0,0,155,
155,155,155,155,155,155,155,155,155,155,155,155,155,155,155,155,155,155,155,155,0,0,0,0,155,
155,0,0,0,0,0,0,0,0,0,0,0,0,0,0,0,0,0,0,0,0,100,76,0,155,
155,0,0,0,0,0,0,0,0,0,0,0,0,0,0,0,0,0,0,0,0,0,0,0,155,
155,0,0,0,0,0,0,0,0,0,0,0,0,0,0,0,0,0,0,0,0,0,0,0,155,
155,221,0,0,0,0,0,0,0,0,0,0,0,0,0,0,0,0,0,0,135,135,135,55,155,
155,0,0,0,61,0,209,0,61,0,193,0,61,0,201,0,61,0,0,0,155,155,155,65,155,
155,135,135,135,135,135,135,135,135,135,135,135,135,135,135,135,135,135,135,135,155,155,155,135,155,
155,155,155,155,155,155,155,155,155,155,155,155,155,155,155,155,155,155,155,155,155,155,155,155,155