155,155,155,155,155,155,155,155,155,155,155,155,155,155,155,155,155,155,155,155,155,155,155,155,155,155,155,155
155,0,0,0,0,0,0,155,201,193,209,0,0,0,0,0,0,0,0,0,0,0,0,0,0,0,0,155,
155,0,221,0,0,0,0,155,201,193,209,0,0,0,0,0,0,0,0,0,0,162,0,0,0,0,0,155,
155,0,0,0,0,0,0,155,201,193,209,162,0,0,0,0,0,0,0,135,135,123,44,44,147,123,0,155,
155,0,0,0,0,0,0,155,135,135,135,135,135,0,0,0,0,0,0,155,193,193,0,0,0,0,0,155,
155,0,0,0,0,0,0,0,0,0,0,0,0,0,0,0,0,0,0,155,193,193,0,0,0,0,0,155,
155,88,88,76,0,0,0,0,0,0,0,0,0,0,0,0,0,0,100,155,0,0,0,0,0,0,0,155,
155,0,0,0,0,0,0,0,0,209,0,0,0,0,0,209,0,0,0,155,0,0,0,0,0,0,0,155,
155,198,0,0,0,0,0,0,0,0,0,0,0,0,0,0,0,0,0,155,135,135,123,55,147,135,135,155,
155,0,0,0,0,0,112,0,0,209,0,0,112,0,0,209,0,0,100,155,201,201,0,0,0,0,0,155,
155,0,0,0,0,0,0,0,0,0,0,0,0,0,0,0,0,0,0,155,201,201,0,0,0,0,0,155,
155,0,0,0,0,0,0,0,0,0,0,0,0,0,0,0,0,0,0,155,0,0,0,0,0,0,0,155,
155,88,88,76,0,0,0,0,0,112,0,0,0,0,0,112,0,0,0,155,0,0,0,0,0,0,65,155,
155,139,139,139,139,139,139,139,139,139,139,139,139,139,139,139,139,139,139,155,135,139,139,139,139,139,135,155,
155,155,155,155,155,155,155,155,155,155,155,155,155,155,155,155,155,155,155,155,155,155,155,155,155,155,155,155